9x9
000000000
001111100
001000100
001011100
000000100
011111100
010000000
011111110
000000020