10 10
1110000012
1010111111
0011110000
0110110100
0001110010
0010000101
1100010010
0001111100
0100000110
0001101110


