10 10
1110000012
1010311111
0011110000
0110410100
0001110010
0050000101
1160010010
0001111100
0100000110
0001101110



